25
2; 2; 2; 2; 2; 2; 2; 2; 2; 2; 2; 2; 2; 2; 2; 2; 2; 2; 2; 2; 2; 2; 2; 2; 2; 2; 2; 2; 2; 2;
2; 10; 11; 1; 1; 1; 1; 1; 1; 1; 1; 1; 1; 1; 1; 1; 1; 1; 1; 1; 1; 1; 1; 1; 1; 1; 1; 1; 1; 2;
2; 12; 13; 1; 1; 1; 1; 1; 1; 1; 1; 1; 1; 1; 1; 1; 1; 1; 1; 1; 1; 1; 1; 1; 1; 1; 1; 1; 1; 2;
2; 14; 15; 1; 1; 1; 1; 1; 1; 1; 1; 1; 1; 1; 1; 1; 1; 1; 1; 1; 1; 1; 1; 1; 1; 1; 1; 1; 1; 2;
2; 1; 1; 1; 1; 1; 1; 1; 1; 1; 1; 1; 1; 1; 1; 1; 1; 1; 1; 1; 1; 1; 1; 1; 1; 1; 1; 1; 1; 2;
2; 1; 1; 1; 1; 1; 1; 1; 1; 1; 1; 1; 1; 1; 1; 1; 1; 1; 1; 1; 1; 1; 1; 1; 1; 1; 1; 1; 1; 2;
2; 1; 1; 1; 1; 1; 1; 1; 1; 1; 1; 1; 1; 1; 1; 1; 1; 1; 1; 1; 1; 1; 1; 1; 1; 1; 1; 1; 1; 2;
2; 1; 1; 1; 1; 1; 1; 1; 1; 1; 1; 1; 1; 1; 1; 1; 1; 1; 1; 1; 1; 1; 1; 1; 1; 1; 1; 1; 1; 2;
2; 1; 1; 1; 1; 1; 1; 1; 1; 1; 1; 1; 1; 1; 1; 1; 1; 1; 1; 1; 1; 1; 1; 1; 1; 1; 1; 1; 1; 2;
2; 1; 1; 1; 1; 1; 1; 1; 1; 1; 1; 1; 1; 1; 1; 1; 1; 1; 1; 1; 1; 1; 1; 1; 1; 1; 1; 1; 1; 2;
2; 1; 1; 1; 1; 1; 1; 1; 1; 1; 1; 1; 1; 1; 1; 1; 1; 1; 1; 1; 1; 1; 1; 1; 1; 1; 1; 1; 1; 2;
2; 1; 1; 1; 1; 1; 1; 1; 1; 1; 1; 1; 1; 1; 1; 1; 1; 1; 1; 1; 1; 1; 1; 1; 1; 1; 1; 1; 1; 2;
2; 1; 1; 1; 1; 1; 1; 1; 1; 1; 1; 1; 1; 1; 1; 1; 1; 1; 1; 1; 1; 1; 1; 1; 1; 1; 1; 1; 1; 2;
2; 1; 1; 1; 1; 1; 1; 1; 1; 1; 1; 1; 1; 1; 1; 1; 1; 1; 1; 1; 1; 1; 1; 1; 1; 1; 1; 1; 1; 2;
2; 1; 1; 1; 1; 1; 1; 1; 1; 1; 1; 1; 1; 1; 1; 1; 1; 1; 1; 1; 1; 1; 1; 1; 1; 1; 1; 1; 1; 2;
2; 1; 1; 1; 1; 1; 1; 1; 1; 1; 1; 1; 1; 1; 1; 1; 1; 1; 1; 1; 1; 1; 1; 1; 1; 1; 1; 1; 1; 2;
2; 1; 1; 1; 1; 1; 1; 1; 1; 1; 1; 1; 1; 1; 1; 1; 1; 1; 1; 1; 1; 1; 1; 1; 1; 1; 1; 1; 1; 2;
2; 1; 1; 1; 1; 1; 1; 1; 1; 1; 1; 1; 1; 1; 1; 1; 1; 1; 1; 1; 1; 1; 1; 1; 1; 1; 1; 1; 1; 2;
2; 1; 1; 1; 1; 1; 1; 1; 1; 1; 1; 1; 1; 1; 1; 1; 1; 1; 1; 1; 1; 1; 1; 1; 1; 1; 1; 1; 1; 2;
2; 1; 1; 1; 1; 1; 1; 1; 1; 1; 1; 1; 1; 1; 1; 1; 1; 1; 1; 1; 1; 1; 1; 1; 1; 1; 1; 1; 1; 2;
2; 1; 1; 1; 1; 1; 1; 1; 1; 1; 1; 1; 1; 1; 1; 1; 1; 1; 1; 1; 1; 1; 1; 1; 1; 1; 1; 1; 1; 2;
2; 1; 1; 1; 1; 1; 1; 1; 1; 1; 1; 1; 1; 1; 1; 1; 1; 1; 1; 1; 1; 1; 1; 1; 1; 1; 1; 10; 11; 2;
2; 1; 1; 1; 1; 1; 1; 1; 1; 1; 1; 1; 1; 1; 1; 1; 1; 1; 1; 1; 1; 1; 1; 1; 1; 1; 1; 12; 13; 2;
2; 1; 1; 1; 1; 1; 1; 1; 1; 1; 1; 1; 1; 1; 1; 1; 1; 1; 1; 1; 1; 1; 1; 1; 1; 1; 1; 14; 15; 2;
2; 2; 2; 2; 2; 2; 2; 2; 2; 2; 2; 2; 2; 2; 2; 2; 2; 2; 2; 2; 2; 2; 2; 2; 2; 2; 2; 2; 2; 2;

2; 2; 2; 2; 2; 2; 2; 2; 2; 2; 2; 2; 2; 2; 2; 2; 2; 2; 2; 2; 2; 2; 2; 2; 2; 2; 2; 2; 2; 2;
2; 0; 0; 0; 17; 18; 0; 17; 18; 0; 17; 18; 0; 17; 18; 0; 17; 18; 0; 17; 18; 0; 17; 18; 0; 17; 18; 0; 0; 2;
2; 0; 0; 0; 0; 0; 0; 0; 0; 0; 0; 0; 0; 0; 0; 0; 0; 0; 0; 0; 0; 0; 0; 0; 0; 0; 0; 0; 0; 2;
2; 0; 0; 0; 0; 0; 0; 0; 0; 0; 0; 0; 0; 0; 0; 0; 0; 0; 0; 0; 0; 0; 0; 0; 0; 0; 0; 0; 0; 2;
2; 0; 0; 0; 0; 0; 0; 20; 21; 0; 20; 21; 0; 20; 21; 0; 20; 21; 0; 20; 21; 0; 0; 0; 0; 0; 23; 24; 25; 2;
2; 0; 0; 0; 0; 0; 0; 7; 7; 0; 7; 7; 0; 7; 7; 0; 7; 7; 0; 7; 7; 0; 0; 0; 0; 0; 17; 18; 26; 2;
2; 0; 0; 0; 0; 0; 0; 0; 0; 0; 0; 0; 0; 0; 0; 0; 0; 0; 0; 0; 0; 0; 0; 0; 0; 0; 0; 0; 0; 2;
2; 0; 0; 0; 0; 0; 0; 0; 0; 0; 0; 0; 0; 0; 0; 0; 0; 0; 0; 0; 0; 0; 0; 0; 0; 0; 0; 0; 0; 2;
2; 25; 0; 0; 0; 27; 27; 23; 24; 27; 27; 23; 24; 27; 27; 23; 24; 27; 27; 23; 24; 0; 0; 0; 0; 0; 23; 24; 25; 2;
2; 26; 0; 0; 0; 17; 18; 17; 18; 17; 18; 17; 18; 17; 18; 17; 18; 17; 18; 17; 18; 0; 0; 0; 0; 0; 17; 18; 26; 2;
2; 0; 0; 0; 0; 0; 0; 0; 0; 0; 0; 0; 0; 0; 0; 0; 0; 0; 0; 0; 0; 0; 0; 0; 0; 0; 0; 0; 0; 2;
2; 25; 0; 0; 0; 27; 27; 23; 24; 27; 27; 23; 24; 27; 27; 23; 24; 27; 27; 23; 24; 0; 0; 0; 0; 0; 23; 24; 25; 2;
2; 26; 0; 0; 0; 17; 18; 17; 18; 17; 18; 17; 18; 17; 18; 17; 18; 17; 18; 17; 18; 0; 0; 0; 0; 0; 17; 18; 26; 2;
2; 0; 0; 0; 0; 0; 0; 0; 0; 0; 0; 0; 0; 0; 0; 0; 0; 0; 0; 0; 0; 0; 0; 0; 0; 0; 0; 0; 0; 2;
2; 25; 0; 0; 0; 27; 27; 23; 24; 27; 27; 23; 24; 27; 27; 23; 24; 27; 27; 23; 24; 0; 0; 0; 0; 0; 23; 24; 25; 2;
2; 26; 0; 0; 0; 17; 18; 17; 18; 17; 18; 17; 18; 17; 18; 17; 18; 17; 18; 17; 18; 0; 0; 0; 0; 0; 17; 18; 26; 2;
2; 0; 0; 0; 0; 0; 0; 0; 0; 0; 0; 0; 0; 0; 0; 0; 0; 0; 0; 0; 0; 0; 0; 0; 0; 0; 0; 0; 0; 2;
2; 25; 0; 0; 0; 27; 27; 23; 24; 27; 27; 23; 24; 27; 27; 23; 24; 27; 27; 23; 24; 0; 0; 0; 0; 0; 23; 24; 25; 2;
2; 26; 0; 0; 0; 17; 18; 17; 18; 17; 18; 17; 18; 17; 18; 17; 18; 17; 18; 17; 18; 0; 0; 0; 0; 0; 17; 18; 26; 2;
2; 0; 0; 0; 0; 0; 0; 0; 0; 0; 0; 0; 0; 0; 0; 0; 0; 0; 0; 0; 0; 0; 0; 0; 0; 0; 0; 0; 0; 2;
2; 25; 0; 0; 0; 0; 0; 0; 0; 0; 0; 0; 0; 0; 0; 0; 0; 0; 0; 0; 0; 0; 0; 0; 0; 0; 0; 0; 0; 2;
2; 26; 0; 0; 0; 3; 4; 5; 0; 0; 3; 4; 5; 0; 0; 3; 4; 5; 0; 0; 3; 4; 5; 0; 0; 0; 0; 0; 0; 2;
2; 0; 0; 0; 0; 0; 7; 0; 0; 0; 0; 7; 0; 0; 0; 0; 7; 0; 0; 0; 0; 7; 0; 0; 0; 0; 0; 0; 0; 2;
2; 0; 0; 0; 0; 0; 0; 0; 0; 0; 0; 0; 0; 0; 0; 0; 0; 0; 0; 0; 0; 0; 0; 0; 0; 0; 0; 0; 0; 2;
2; 2; 2; 2; 2; 2; 2; 2; 2; 2; 2; 2; 2; 2; 2; 2; 2; 2; 2; 2; 2; 2; 2; 2; 2; 2; 2; 2; 2; 2;

2; 2; 2; 2; 2; 2; 2; 2; 2; 2; 2; 2; 2; 2; 2; 2; 2; 2; 2; 2; 2; 2; 2; 2; 2; 2; 2; 2; 2; 2;
2; 0; 0; 0; 0; 0; 0; 0; 0; 0; 0; 0; 0; 0; 0; 0; 0; 0; 0; 0; 0; 0; 0; 0; 0; 0; 0; 0; 0; 2;
2; 0; 0; 0; 0; 0; 0; 0; 0; 0; 0; 0; 0; 0; 0; 0; 0; 0; 0; 0; 0; 0; 0; 0; 0; 0; 0; 0; 0; 2;
2; 0; 0; 0; 0; 0; 0; 0; 0; 0; 0; 0; 0; 0; 0; 0; 0; 0; 0; 0; 0; 0; 0; 0; 0; 0; 0; 0; 0; 2;
2; 0; 0; 0; 0; 0; 0; 0; 0; 0; 0; 0; 0; 0; 0; 0; 0; 0; 0; 0; 0; 0; 0; 0; 0; 0; 0; 0; 0; 2;
2; 0; 0; 0; 0; 0; 0; 0; 0; 0; 0; 0; 0; 0; 0; 0; 0; 0; 0; 0; 0; 0; 0; 0; 0; 0; 0; 0; 0; 2;
2; 0; 0; 0; 0; 0; 0; 0; 0; 0; 0; 0; 0; 0; 0; 0; 0; 0; 0; 0; 0; 0; 0; 0; 0; 0; 0; 0; 0; 2;
2; 0; 0; 0; 0; 0; 0; 0; 0; 0; 0; 0; 0; 0; 0; 0; 0; 0; 0; 0; 0; 0; 0; 0; 0; 0; 0; 0; 0; 2;
2; 0; 0; 0; 0; 0; 0; 0; 0; 0; 0; 0; 0; 0; 0; 0; 0; 0; 0; 0; 0; 0; 0; 0; 0; 0; 0; 0; 0; 2;
2; 0; 0; 0; 0; 0; 0; 0; 0; 0; 0; 0; 0; 0; 0; 0; 0; 0; 0; 0; 0; 0; 0; 0; 0; 0; 0; 0; 0; 2;
2; 0; 0; 0; 0; 0; 0; 0; 0; 0; 0; 0; 0; 0; 0; 0; 0; 0; 0; 0; 0; 0; 0; 0; 0; 0; 0; 0; 0; 2;
2; 0; 0; 0; 0; 0; 0; 0; 0; 0; 0; 0; 0; 0; 0; 0; 0; 0; 0; 0; 0; 0; 0; 0; 0; 0; 0; 0; 0; 2;
2; 0; 0; 0; 0; 0; 0; 0; 0; 0; 0; 0; 0; 0; 0; 0; 0; 0; 0; 0; 0; 0; 0; 0; 0; 0; 0; 0; 0; 2;
2; 0; 0; 0; 0; 0; 0; 0; 0; 0; 0; 0; 0; 0; 0; 0; 0; 0; 0; 0; 0; 0; 0; 0; 0; 0; 0; 0; 0; 2;
2; 0; 0; 0; 0; 0; 0; 0; 0; 0; 0; 0; 0; 0; 0; 0; 0; 0; 0; 0; 0; 0; 0; 0; 0; 0; 0; 0; 0; 2;
2; 0; 0; 0; 0; 0; 0; 0; 0; 0; 0; 0; 0; 0; 0; 0; 0; 0; 0; 0; 0; 0; 0; 0; 0; 0; 0; 0; 0; 2;
2; 0; 0; 0; 0; 0; 0; 0; 0; 0; 0; 0; 0; 0; 0; 0; 0; 0; 0; 0; 0; 0; 0; 0; 0; 0; 0; 0; 0; 2;
2; 0; 0; 0; 0; 0; 0; 0; 0; 0; 0; 0; 0; 0; 0; 0; 0; 0; 0; 0; 0; 0; 0; 0; 0; 0; 0; 0; 0; 2;
2; 0; 0; 0; 0; 0; 0; 0; 0; 0; 0; 0; 0; 0; 0; 0; 0; 0; 0; 0; 0; 0; 0; 0; 0; 0; 0; 0; 0; 2;
2; 0; 0; 0; 0; 0; 0; 0; 0; 0; 0; 0; 0; 0; 0; 0; 0; 0; 0; 0; 0; 0; 0; 0; 0; 0; 0; 0; 0; 2;
2; 0; 0; 0; 0; 0; 8; 0; 0; 0; 0; 8; 0; 0; 0; 0; 8; 0; 0; 0; 0; 8; 0; 0; 0; 0; 0; 0; 0; 2;
2; 0; 0; 0; 0; 0; 9; 0; 0; 0; 0; 9; 0; 0; 0; 0; 9; 0; 0; 0; 0; 9; 0; 0; 0; 0; 0; 0; 0; 2;
2; 0; 0; 0; 0; 0; 0; 0; 0; 0; 0; 0; 0; 0; 0; 0; 0; 0; 0; 0; 0; 0; 0; 0; 0; 0; 0; 0; 0; 2;
2; 0; 0; 0; 0; 0; 0; 0; 0; 0; 0; 0; 0; 0; 0; 0; 0; 0; 0; 0; 0; 0; 0; 0; 0; 0; 0; 0; 0; 2;
2; 2; 2; 2; 2; 2; 2; 2; 2; 2; 2; 2; 2; 2; 2; 2; 2; 2; 2; 2; 2; 2; 2; 2; 2; 2; 2; 2; 2; 2;

B Rect=(0,-1,1900,60) #LINE TOP
B Rect=(1540,-1,1900,60) #LINE BOTTOM
B Rect=(0,-1,60,1600) #BLOCK MUR GAUCHE
B Rect=(0,1856,60,1600) #BLOCK MUR DROIT
B Rect=(520,315,1050,128) #GENERATORS LINE 1
B Rect=(720,315,1050,128) #GENERATORS LINE 2
B Rect=(890,315,1050,128) #GENERATORS LINE 3
B Rect=(1090,315,1050,128) #GENERATORS LINE 3
B Rect=(1345,320,200,100) #COMPUTER 1
B Rect=(1345,640,200,100) #COMPUTER 2
B Rect=(1345,950,200,100) #COMPUTER 3
B Rect=(1345,1280,200,100) #COMPUTER 4
B Rect=(260,447,130,100) #CONSOLE TOP 1
B Rect=(260,640,130,100) #CONSOLE TOP 2
B Rect=(260,832,130,100) #CONSOLE TOP 3
B Rect=(260,1030,130,100) #CONSOLE TOP 4
B Rect=(260,1220,130,100) #CONSOLE TOP 5
B Rect=(60,260,130,60) #GENERATORS TOP 1
B Rect=(60,447,130,60) #GENERATORS TOP 2
B Rect=(60,645,130,60) #GENERATORS TOP 3
B Rect=(60,833,130,60) #GENERATORS TOP 4
B Rect=(60,1028,130,60) #GENERATORS TOP 5
B Rect=(60,1215,130,60) #GENERATORS TOP 6
B Rect=(60,1410r,130,60) #GENERATORS TOP 7
B Rect=(60,1600,130,60) #GENERATORS TOP 8
B Rect=(520,60,60,120) #GENERATORS LEFT 1
B Rect=(710,60,60,120) #GENERATORS LEFT 2
B Rect=(900,60,60,120) #GENERATORS LEFT 3
B Rect=(1095,60,60,120) #GENERATORS LEFT 4
B Rect=(1280,60,60,120) #GENERATORS LEFT 5
B Rect=(260,1660,190,120) #PLANTS SIDE 1
B Rect=(520,1660,190,120) #PLANTS SIDE 2
B Rect=(710,1660,190,120) #PLANTS SIDE 3
B Rect=(900,1660,190,120) #PLANTS SIDE 4
B Rect=(1090,1660,190,120) #PLANTS SIDE 5

E Pos_rect=(80,80) Size_rect=(100,180) Active=1 ID=10 Contact=change_map Effect="Path='assets/map/servers' Pos=(1700,1300) "
E Pos_rect=(1740,1350) Size_rect=(100,180) Active=1 ID=10 Contact=change_map Path="tests/arbre.png" Effect="Path='assets/map/kitchen' Pos=(200,200) "
# E Pos_obj=(160,300) Rect=(0,0,64,64) Pos_rect=1850,1150) Active=1 Size_rect=(164,164) Path="tests/arbre.png" ID=11 Contact=duel Effect="ID=10 Lvl=20 Reward=(XP=10,2) "
# ROBOT GRIS
E Pos_obj=(470,650) Rect=(0,370,100,100) Pos_rect=(630,620) Active=1 Size_rect=(70,70) Path_obj="assets/images/enemies.png" ID=3 Contact=duel Effect="ID=10 Lvl=2 Reward=(XP=30 Item={Name='Energy Orb' Type='Usage' Nbr=15 ID=9 Mana_act=20}) "
E Pos_obj=(1000,850) Rect=(0,370,100,100) Pos_rect=(1160,820) Active=1 Size_rect=(70,70) Path_obj="assets/images/enemies.png" ID=3 Contact=duel Effect="ID=10 Lvl=2 Reward=(XP=30 Item={Name='Fullmetal Jacket' Type='Chestplate' Nbr=1 ID=4 Armor=50 Speed=-5 AD=15 AP=-10}) "
# ROBOT BLEU
E Pos_obj=(70,600) Rect=(0,300,50,100) Pos_rect=(210,570) Active=1 Size_rect=(50,70) Path_obj="assets/images/enemies.png" ID=4 Contact=duel Effect="ID=10 Lvl=2 Reward=(XP=30 Item={Name='Nanite Shirt' Type='Chestplate' Armor=15 Magic_resi=50 Mana_max=50}) "
E Pos_obj=(1370,800) Rect=(0,300,50,100) Pos_rect=(1510,770) Active=1 Size_rect=(50,70) Path_obj="assets/images/enemies.png" ID=4 Contact=duel Effect="ID=10 Lvl=2 Reward=(XP=30 Item={Name='Great Life Orb' Type='Usage' ID=10 Nbr=10 HP_act=100 HP_max=50}) "
# BOSS
E Pos_obj=(900,1250) Rect=(0,0,100,100) Pos_rect=(850,1190) Active=1 Size_rect=(90,90) Path_obj="assets/images/enemies.png" ID=7 Contact=duel Effect="ID=10 Lvl=2 Reward=(XP=100 Item={Name='Eternity Orb' Type='Usage' ID=9 Nbr=1 Mana_max=100 Mana_act=50}) "
