13
65;65;0;65;65;65;65;65;65;65;65;
65;65;0;65;65;65;65;65;65;65;65;
65;65;0;65;65;65;65;65;65;65;65;
65;65;0;65;65;65;65;65;65;65;65;
65;65;0;65;65;65;65;65;65;65;65;
65;65;0;65;65;65;65;65;65;65;65;
65;65;0;65;65;65;65;65;65;65;65;
65;65;0;65;65;65;65;65;65;65;65;
65;65;0;65;65;65;65;65;65;65;65;
65;65;0;65;65;65;65;65;65;65;65;
65;65;0;65;65;65;65;65;65;65;65;
65;65;0;65;65;65;65;65;65;65;65;
0;65;65;65;65;65;0;65;65;65;65;

0;0;0;65;0;66;65;0;0;0;66;
66;0;0;0;66;66;0;66;0;0;66;
65;65;0;65;65;65;65;65;65;65;65;
65;65;0;65;65;65;65;65;65;65;65;
65;65;0;65;65;65;65;65;65;65;65;
65;65;0;65;65;65;65;65;65;65;65;
65;65;0;65;65;65;65;65;65;65;65;
65;65;0;65;65;65;65;65;65;65;65;
65;65;0;65;65;65;65;65;65;65;65;
65;65;0;65;65;65;65;65;65;65;65;
65;65;0;65;65;65;65;65;65;65;65;
65;65;0;65;65;65;65;65;65;65;65;
65;65;0;65;65;65;65;65;65;65;65;

B Rect=(0,0,704,1)
B Rect=(831,0,704,1)
B Rect=(0,-1,1,832)
B Rect=(0,704,1,832)
E Pos=(,) Size=(,) Mov={(,);(,)} ID= Contact= ID_texture= Effect=""
E Pos_obj=(160,300) Rect=(0,0,64,64) Pos_rect=1850,1150) Active=1 Size_rect=(164,164) Path="tests/arbre.png" ID=11 Contact=duel Effect="ID=10 Lvl=20 Reward=(XP=10,2) "