25
2; 2; 2; 2; 2; 2; 2; 2; 2; 2; 2; 2; 2; 2; 2; 2; 2; 2; 2; 2; 2; 2; 2; 2; 2; 2; 2; 2; 2; 2;
2; 10; 11; 1; 1; 1; 1; 1; 1; 1; 1; 1; 1; 1; 1; 1; 1; 1; 1; 1; 1; 1; 1; 1; 1; 1; 1; 1; 1; 2;
2; 12; 13; 1; 1; 1; 1; 1; 1; 1; 1; 1; 1; 1; 1; 1; 1; 1; 1; 1; 1; 1; 1; 1; 1; 1; 1; 1; 1; 2;
2; 14; 15; 1; 1; 1; 1; 1; 1; 1; 1; 1; 1; 1; 1; 1; 1; 1; 1; 1; 1; 1; 1; 1; 1; 1; 1; 1; 1; 2;
2; 1; 1; 1; 1; 1; 1; 1; 1; 1; 1; 1; 1; 1; 1; 1; 1; 1; 1; 1; 1; 1; 1; 1; 1; 1; 1; 1; 1; 2;
2; 1; 1; 1; 1; 1; 1; 1; 1; 1; 1; 1; 1; 1; 1; 1; 1; 1; 1; 1; 1; 1; 1; 1; 1; 1; 1; 1; 1; 2;
2; 1; 1; 1; 1; 1; 1; 1; 1; 1; 1; 1; 1; 1; 1; 1; 1; 1; 1; 1; 1; 1; 1; 1; 1; 1; 1; 1; 1; 2;
2; 1; 1; 1; 1; 1; 1; 1; 1; 1; 1; 1; 1; 1; 1; 1; 1; 1; 1; 1; 1; 1; 1; 1; 1; 1; 1; 1; 1; 2;
2; 1; 1; 1; 1; 1; 1; 1; 1; 1; 1; 1; 1; 1; 1; 1; 1; 1; 1; 1; 1; 1; 1; 1; 1; 1; 1; 1; 1; 2;
2; 1; 1; 1; 1; 1; 1; 1; 1; 1; 1; 1; 1; 1; 1; 1; 1; 1; 1; 1; 1; 1; 1; 1; 1; 1; 1; 1; 1; 2;
2; 1; 1; 1; 1; 1; 1; 1; 1; 1; 1; 1; 1; 1; 1; 1; 1; 1; 1; 1; 1; 1; 1; 1; 1; 1; 1; 1; 1; 2;
2; 1; 1; 1; 1; 1; 1; 1; 1; 1; 1; 1; 1; 1; 1; 1; 1; 1; 1; 1; 1; 1; 1; 1; 1; 1; 1; 1; 1; 2;
2; 1; 1; 1; 1; 1; 1; 1; 1; 1; 1; 1; 1; 1; 1; 1; 1; 1; 1; 1; 1; 1; 1; 1; 1; 1; 1; 1; 1; 2;
2; 1; 1; 1; 1; 1; 1; 1; 1; 1; 1; 1; 1; 1; 1; 1; 1; 1; 1; 1; 1; 1; 1; 1; 1; 1; 1; 1; 1; 2;
2; 1; 1; 1; 1; 1; 1; 1; 1; 1; 1; 1; 1; 1; 1; 1; 1; 1; 1; 1; 1; 1; 1; 1; 1; 1; 1; 1; 1; 2;
2; 1; 1; 1; 1; 1; 1; 1; 1; 1; 1; 1; 1; 1; 1; 1; 1; 1; 1; 1; 1; 1; 1; 1; 1; 1; 1; 1; 1; 2;
2; 1; 1; 1; 1; 1; 1; 1; 1; 1; 1; 1; 1; 1; 1; 1; 1; 1; 1; 1; 1; 1; 1; 1; 1; 1; 1; 1; 1; 2;
2; 1; 1; 1; 1; 1; 1; 1; 1; 1; 1; 1; 1; 1; 1; 1; 1; 1; 1; 1; 1; 1; 1; 1; 1; 1; 1; 1; 1; 2;
2; 1; 1; 1; 1; 1; 1; 1; 1; 1; 1; 1; 1; 1; 1; 1; 1; 1; 1; 1; 1; 1; 1; 1; 1; 1; 1; 1; 1; 2;
2; 1; 1; 1; 1; 1; 1; 1; 1; 1; 1; 1; 1; 1; 1; 1; 1; 1; 1; 1; 1; 1; 1; 1; 1; 1; 1; 1; 1; 2;
2; 1; 1; 1; 1; 1; 1; 1; 1; 1; 1; 1; 1; 1; 1; 1; 1; 1; 1; 1; 1; 1; 1; 1; 1; 1; 1; 1; 1; 2;
2; 1; 1; 1; 1; 1; 1; 1; 1; 1; 1; 1; 1; 1; 1; 1; 1; 1; 1; 1; 1; 1; 1; 1; 1; 1; 1; 10; 11; 2;
2; 1; 1; 1; 1; 1; 1; 1; 1; 1; 1; 1; 1; 1; 1; 1; 1; 1; 1; 1; 1; 1; 1; 1; 1; 1; 1; 12; 13; 2;
2; 1; 1; 1; 1; 1; 1; 1; 1; 1; 1; 1; 1; 1; 1; 1; 1; 1; 1; 1; 1; 1; 1; 1; 1; 1; 1; 14; 15; 2;
2; 2; 2; 2; 2; 2; 2; 2; 2; 2; 2; 2; 2; 2; 2; 2; 2; 2; 2; 2; 2; 2; 2; 2; 2; 2; 2; 2; 2; 2;

0; 0; 0; 0; 0; 0; 0; 0; 0; 0; 0; 0; 0; 0; 0; 0; 0; 0; 0; 0; 0; 0; 0; 0; 0; 0; 0; 0; 0; 0;
0; 0; 0; 0; 17; 18; 17; 18; 17; 18; 17; 18; 17; 18; 17; 18; 17; 18; 17; 18; 17; 18; 17; 18; 17; 18; 17; 18; 17; 18;
0; 0; 0; 0; 17; 18; 17; 18; 17; 18; 17; 18; 17; 18; 17; 18; 17; 18; 17; 18; 17; 18; 17; 18; 17; 18; 17; 18; 17; 18;
0; 0; 0; 0; 0; 0; 0; 0; 0; 0; 0; 0; 0; 0; 0; 0; 0; 0; 0; 0; 0; 0; 0; 0; 0; 0; 0; 0; 0; 0;
0; 0; 0; 0; 0; 0; 0; 0; 0; 0; 0; 0; 0; 0; 0; 0; 0; 0; 0; 0; 0; 0; 0; 0; 0; 0; 0; 0; 0; 0;
0; 0; 0; 0; 0; 0; 0; 0; 0; 0; 0; 0; 0; 0; 0; 0; 0; 0; 0; 0; 0; 0; 0; 0; 0; 0; 0; 0; 0; 0;
0; 0; 0; 0; 0; 0; 0; 0; 0; 0; 0; 0; 0; 0; 0; 0; 0; 0; 0; 0; 0; 0; 0; 0; 0; 0; 0; 0; 0; 0;
0; 0; 0; 0; 0; 3; 4; 5; 0; 3; 4; 5; 0; 3; 4; 5; 0; 3; 4; 5; 0; 3; 4; 5; 0; 0; 0; 0; 0; 0;
0; 0; 0; 0; 0; 0; 7; 0; 0; 0; 7; 0; 0; 0; 7; 0; 0; 0; 7; 0; 0; 0; 7; 0; 0; 0; 0; 0; 0; 0;
0; 0; 0; 0; 0; 0; 0; 0; 0; 0; 0; 0; 0; 0; 0; 0; 0; 0; 0; 0; 0; 0; 0; 0; 0; 0; 0; 0; 0; 0;
0; 0; 0; 0; 0; 0; 0; 0; 0; 0; 0; 0; 0; 0; 0; 0; 0; 0; 0; 0; 0; 0; 0; 0; 0; 0; 0; 0; 0; 0;
0; 0; 0; 0; 0; 3; 4; 5; 0; 3; 4; 5; 0; 3; 4; 5; 0; 3; 4; 5; 0; 3; 4; 5; 0; 0; 0; 0; 0; 0;
0; 0; 0; 0; 0; 0; 7; 0; 0; 0; 7; 0; 0; 0; 7; 0; 0; 0; 7; 0; 0; 0; 7; 0; 0; 0; 0; 0; 0; 0;
0; 0; 0; 0; 0; 0; 0; 0; 0; 0; 0; 0; 0; 0; 0; 0; 0; 0; 0; 0; 0; 0; 0; 0; 0; 0; 0; 0; 0; 0;
0; 0; 0; 0; 0; 3; 4; 5; 0; 3; 4; 5; 0; 3; 4; 5; 0; 3; 4; 5; 0; 3; 4; 5; 0; 0; 0; 0; 0; 0;
0; 0; 0; 0; 0; 0; 7; 0; 0; 0; 7; 0; 0; 0; 7; 0; 0; 0; 7; 0; 0; 0; 7; 0; 0; 0; 0; 0; 0; 0;
0; 0; 0; 0; 0; 0; 0; 0; 0; 0; 0; 0; 0; 0; 0; 0; 0; 0; 0; 0; 0; 0; 0; 0; 0; 0; 0; 0; 0; 0;
0; 0; 0; 0; 0; 0; 0; 0; 0; 0; 0; 0; 0; 0; 0; 0; 0; 0; 0; 0; 0; 0; 0; 0; 0; 0; 0; 0; 0; 0;
0; 0; 0; 0; 0; 0; 0; 0; 0; 0; 0; 0; 0; 0; 0; 0; 0; 0; 0; 0; 0; 0; 0; 0; 0; 0; 0; 0; 0; 0;
0; 0; 0; 0; 0; 3; 4; 5; 0; 3; 4; 5; 0; 3; 4; 5; 0; 3; 4; 5; 0; 3; 4; 5; 0; 0; 0; 0; 0; 0;
0; 0; 0; 0; 0; 0; 7; 0; 0; 0; 7; 0; 0; 0; 7; 0; 0; 0; 7; 0; 0; 0; 7; 0; 0; 0; 0; 0; 0; 0;
0; 0; 0; 0; 0; 0; 0; 0; 0; 0; 0; 0; 0; 0; 0; 0; 0; 0; 0; 0; 0; 0; 0; 0; 0; 0; 0; 0; 0; 0;
0; 0; 0; 0; 0; 0; 0; 0; 0; 0; 0; 0; 0; 0; 0; 0; 0; 0; 0; 0; 0; 0; 0; 0; 0; 0; 0; 0; 0; 0;
0; 0; 0; 0; 0; 0; 0; 0; 0; 0; 0; 0; 0; 0; 0; 0; 0; 0; 0; 0; 0; 0; 0; 0; 0; 0; 0; 0; 0; 0;
0; 2; 2; 2; 2; 2; 2; 2; 2; 2; 2; 2; 2; 2; 2; 2; 2; 2; 2; 2; 2; 2; 2; 2; 2; 2; 2; 2; 2; 0;

2; 2; 2; 2; 2; 2; 2; 2; 2; 2; 2; 2; 2; 2; 2; 2; 2; 2; 2; 2; 2; 2; 2; 2; 2; 2; 2; 2; 2; 2;
2; 0; 0; 0; 0; 0; 0; 0; 0; 0; 0; 0; 0; 0; 0; 0; 0; 0; 0; 0; 0; 0; 0; 0; 0; 0; 0; 0; 0; 2;
2; 0; 0; 0; 0; 0; 0; 0; 0; 0; 0; 0; 0; 0; 0; 0; 0; 0; 0; 0; 0; 0; 0; 0; 0; 0; 0; 0; 0; 2;
2; 0; 0; 0; 0; 0; 0; 0; 0; 0; 0; 0; 0; 0; 0; 0; 0; 0; 0; 0; 0; 0; 0; 0; 0; 0; 0; 0; 0; 2;
2; 0; 0; 0; 0; 0; 0; 0; 0; 0; 0; 0; 0; 0; 0; 0; 0; 0; 0; 0; 0; 0; 0; 0; 0; 0; 0; 0; 0; 2;
2; 0; 0; 0; 0; 0; 0; 0; 0; 0; 0; 0; 0; 0; 0; 0; 0; 0; 0; 0; 0; 0; 0; 0; 0; 0; 0; 0; 0; 2;
2; 0; 0; 0; 0; 0; 8; 0; 0; 0; 8; 0; 0; 0; 8; 0; 0; 0; 8; 0; 0; 0; 8; 0; 0; 0; 0; 0; 0; 2;
2; 0; 0; 0; 0; 0; 9; 0; 0; 0; 9; 0; 0; 0; 9; 0; 0; 0; 9; 0; 0; 0; 9; 0; 0; 0; 0; 0; 0; 2;
2; 0; 0; 0; 0; 0; 0; 0; 0; 0; 0; 0; 0; 0; 0; 0; 0; 0; 0; 0; 0; 0; 0; 0; 0; 0; 0; 0; 0; 2;
2; 0; 0; 0; 0; 0; 0; 0; 0; 0; 0; 0; 0; 0; 0; 0; 0; 0; 0; 0; 0; 0; 0; 0; 0; 0; 0; 0; 0; 2;
2; 0; 0; 0; 0; 0; 8; 0; 0; 0; 8; 0; 0; 0; 8; 0; 0; 0; 8; 0; 0; 0; 8; 0; 0; 0; 0; 0; 0; 2;
2; 0; 0; 0; 0; 0; 9; 0; 0; 0; 9; 0; 0; 0; 9; 0; 0; 0; 9; 0; 0; 0; 9; 0; 0; 0; 0; 0; 0; 2;
2; 0; 0; 0; 0; 0; 0; 0; 0; 0; 0; 0; 0; 0; 0; 0; 0; 0; 0; 0; 0; 0; 0; 0; 0; 0; 0; 0; 0; 2;
2; 0; 0; 0; 0; 0; 8; 0; 0; 0; 8; 0; 0; 0; 8; 0; 0; 0; 8; 0; 0; 0; 8; 0; 0; 0; 0; 0; 0; 2;
2; 0; 0; 0; 0; 0; 9; 0; 0; 0; 9; 0; 0; 0; 9; 0; 0; 0; 9; 0; 0; 0; 9; 0; 0; 0; 0; 0; 0; 2;
2; 0; 0; 0; 0; 0; 0; 0; 0; 0; 0; 0; 0; 0; 0; 0; 0; 0; 0; 0; 0; 0; 0; 0; 0; 0; 0; 0; 0; 2;
2; 0; 0; 0; 0; 0; 0; 0; 0; 0; 0; 0; 0; 0; 0; 0; 0; 0; 0; 0; 0; 0; 0; 0; 0; 0; 0; 0; 0; 2;
2; 0; 0; 0; 0; 0; 0; 0; 0; 0; 0; 0; 0; 0; 0; 0; 0; 0; 0; 0; 0; 0; 0; 0; 0; 0; 0; 0; 0; 2;
2; 0; 0; 0; 0; 0; 8; 0; 0; 0; 8; 0; 0; 0; 8; 0; 0; 0; 8; 0; 0; 0; 8; 0; 0; 0; 0; 0; 0; 2;
2; 0; 0; 0; 0; 0; 9; 0; 0; 0; 9; 0; 0; 0; 9; 0; 0; 0; 9; 0; 0; 0; 9; 0; 0; 0; 0; 0; 0; 2;
2; 0; 0; 0; 0; 0; 0; 0; 0; 0; 0; 0; 0; 0; 0; 0; 0; 0; 0; 0; 0; 0; 0; 0; 0; 0; 0; 0; 0; 2;
2; 0; 0; 0; 0; 0; 0; 0; 0; 0; 0; 0; 0; 0; 0; 0; 0; 0; 0; 0; 0; 0; 0; 0; 0; 0; 0; 0; 0; 2;
2; 0; 0; 0; 0; 0; 0; 0; 0; 0; 0; 0; 0; 0; 0; 0; 0; 0; 0; 0; 0; 0; 0; 0; 0; 0; 0; 0; 0; 2;
2; 0; 0; 0; 0; 0; 0; 0; 0; 0; 0; 0; 0; 0; 0; 0; 0; 0; 0; 0; 0; 0; 0; 0; 0; 0; 0; 0; 0; 2;
2; 2; 2; 2; 2; 2; 2; 2; 2; 2; 2; 2; 2; 2; 2; 2; 2; 2; 2; 2; 2; 2; 2; 2; 2; 2; 2; 2; 2; 2;

B Rect=(0,-1,1900,60) #LINE TOP
B Rect=(1545,-1,1900,60) #LINE BOTTOM
B Rect=(0,245,1700,185) #BLOCK HAUT DROIT
B Rect=(0,-1,60,1600) #BLOCK MUR GAUCHE
B Rect=(0,1850,60,1600) #BLOCK MUR DROIT
B Rect=(445,320,195,120) #COMPUTER A1
B Rect=(445,580,195,120) #COMPUTER A2
B Rect=(445,830,195,120) #COMPUTER A3
B Rect=(445,1090,195,120) #COMPUTER A4
B Rect=(445,1345,195,120) #COMPUTER A5
B Rect=(700,320,195,120) #COMPUTER B1
B Rect=(700,580,195,120) #COMPUTER B2
B Rect=(700,830,195,120) #COMPUTER B3
B Rect=(700,1090,195,120) #COMPUTER B4
B Rect=(700,1345,195,120) #COMPUTER B5
B Rect=(895,320,195,120) #COMPUTER C1
B Rect=(895,580,195,120) #COMPUTER C2
B Rect=(895,830,195,120) #COMPUTER C3
B Rect=(895,1090,195,120) #COMPUTER C4
B Rect=(895,1345,195,120) #COMPUTER C5
B Rect=(1215,320,195,120) #COMPUTER D1
B Rect=(1215,580,195,120) #COMPUTER D2
B Rect=(1215,830,195,120) #COMPUTER D3
B Rect=(1215,1090,195,120) #COMPUTER D4
B Rect=(1215,1345,195,120) #COMPUTER D5

E Pos_rect=(1740,1350) Size_rect=(100,180) Active=1 ID=10 Contact=change_map Effect="Path='assets/map/servers' Pos=(200,200) "
E Pos_rect=(500,500) Size_rect=(180,180) Pos_obj=(300,700) Rect=(0,360,100,400) Active=1 Path_obj="assets/images/enemies.png" ID=10 Contact=chat Effect="assets/dialogue/dialogue_start"
E Pos_obj=(750,500) Rect=(0,360,100,400) Pos_rect=(910,320) Active=1 Size_rect=(50,50) Path_obj="assets/images/enemies.png" ID=11 Contact=duel Effect="ID=3 Lvl=1 Reward=(XP=10 Item={Name='Life Orb' Type='Usage' Nbr=5 ID=10 HP_act=20})  " #MILITAIRE HAUT
E Pos_obj=(1425,1000) Rect=(0,360,100,400) Pos_rect=(1595,820) Active=1 Size_rect=(50,50) Path_obj="assets/images/enemies.png" ID=11 Contact=duel Effect="ID=3 Lvl=1 Reward=(XP=10 Item={Name='Energy Orb' Type='Usage' Nbr=3 ID=9 Mana_act=20}) " #MILITAIRE BAS DROITE
E Pos_obj=(25,1000) Rect=(0,360,100,400) Pos_rect=(195,820) Active=1 Size_rect=(50,50) Path_obj="assets/images/enemies.png" ID=11 Contact=duel Effect="ID=3 Lvl=2 Reward=(XP=10 Item={Name='Simple Jacket' Type='Chestplate' Nbr=1 ID=6 HP_max=5 Armor=2}) " #MILITAIRE BAS GAUCHE
E Pos_obj=(725,1020) Rect=(0,450,100,100) Pos_rect=(930,1005) Active=1 Size_rect=(40,40) Path_obj="assets/images/enemies.png" ID=11 Contact=duel Effect="ID=9 Lvl=1 Reward=(XP=10 Item={Name='Spitfire Boots' Type='Boots' Nbr=1 ID=8 Armor=-15 Magic_Resi=-10 Speed=10 AD=15}) " #JOSIE
