25
2; 2; 2; 2; 2; 2; 2; 2; 2; 2; 2; 2; 2; 2; 2; 2; 2; 2; 2; 2; 2; 2; 2; 2; 2; 2; 2; 2; 2; 2;
2; 10; 11; 1; 1; 1; 1; 1; 1; 1; 1; 1; 1; 1; 1; 1; 1; 1; 1; 1; 1; 1; 1; 1; 1; 1; 1; 1; 1; 2;
2; 12; 13; 1; 1; 1; 1; 1; 1; 1; 1; 1; 1; 1; 1; 1; 1; 1; 1; 1; 1; 1; 1; 1; 1; 1; 1; 1; 1; 2;
2; 14; 15; 1; 1; 1; 1; 1; 1; 1; 1; 1; 1; 1; 1; 1; 1; 1; 1; 1; 1; 1; 1; 1; 1; 1; 1; 1; 1; 2;
2; 1; 1; 1; 1; 1; 1; 1; 1; 1; 1; 1; 1; 1; 1; 1; 1; 1; 1; 1; 1; 1; 1; 1; 1; 1; 1; 1; 1; 2;
2; 1; 1; 1; 1; 1; 1; 1; 1; 1; 1; 1; 1; 1; 1; 1; 1; 1; 1; 1; 1; 1; 1; 1; 1; 1; 1; 1; 1; 2;
2; 1; 1; 1; 1; 1; 1; 1; 1; 1; 1; 1; 1; 1; 1; 1; 1; 1; 1; 1; 1; 1; 1; 1; 1; 1; 1; 1; 1; 2;
2; 1; 1; 1; 1; 1; 1; 1; 1; 1; 1; 1; 1; 1; 1; 1; 1; 1; 1; 1; 1; 1; 1; 1; 1; 1; 1; 1; 1; 2;
2; 1; 1; 1; 1; 1; 1; 1; 1; 1; 1; 1; 1; 1; 1; 1; 1; 1; 1; 1; 1; 1; 1; 1; 1; 1; 1; 1; 1; 2;
2; 1; 1; 1; 1; 1; 1; 1; 1; 1; 1; 1; 1; 1; 1; 1; 1; 1; 1; 1; 1; 1; 1; 1; 1; 1; 1; 1; 1; 2;
2; 1; 1; 1; 1; 1; 1; 1; 1; 1; 1; 1; 1; 1; 1; 1; 1; 1; 1; 1; 1; 1; 1; 1; 1; 1; 1; 1; 1; 2;
2; 1; 1; 1; 1; 1; 1; 1; 1; 1; 1; 1; 1; 1; 1; 1; 1; 1; 1; 1; 1; 1; 1; 1; 1; 1; 1; 1; 1; 2;
2; 1; 1; 1; 1; 1; 1; 1; 1; 1; 1; 1; 1; 1; 1; 1; 1; 1; 1; 1; 1; 1; 1; 1; 1; 1; 1; 1; 1; 2;
2; 1; 1; 1; 1; 1; 1; 1; 1; 1; 1; 1; 1; 1; 1; 1; 1; 1; 1; 1; 1; 1; 1; 1; 1; 1; 1; 1; 1; 2;
2; 1; 1; 1; 1; 1; 1; 1; 1; 1; 1; 1; 1; 1; 1; 1; 1; 1; 1; 1; 1; 1; 1; 1; 1; 1; 1; 1; 1; 2;
2; 1; 1; 1; 1; 1; 1; 1; 1; 1; 1; 1; 1; 1; 1; 1; 1; 1; 1; 1; 1; 1; 1; 1; 1; 1; 1; 1; 1; 2;
2; 1; 1; 1; 1; 1; 1; 1; 1; 1; 1; 1; 1; 1; 1; 1; 1; 1; 1; 1; 1; 1; 1; 1; 1; 1; 1; 1; 1; 2;
2; 1; 1; 1; 1; 1; 1; 1; 1; 1; 1; 1; 1; 1; 1; 1; 1; 1; 1; 1; 1; 1; 1; 1; 1; 1; 1; 1; 1; 2;
2; 1; 1; 1; 1; 1; 1; 1; 1; 1; 1; 1; 1; 1; 1; 1; 1; 1; 1; 1; 1; 1; 1; 1; 1; 1; 1; 1; 1; 2;
2; 1; 1; 1; 1; 1; 1; 1; 1; 1; 1; 1; 1; 1; 1; 1; 1; 1; 1; 1; 1; 1; 1; 1; 1; 1; 1; 1; 1; 2;
2; 1; 1; 1; 1; 1; 1; 1; 1; 1; 1; 1; 1; 1; 1; 1; 1; 1; 1; 1; 1; 1; 1; 1; 1; 1; 1; 1; 1; 2;
2; 1; 1; 1; 1; 1; 1; 1; 1; 1; 1; 1; 1; 1; 1; 1; 1; 1; 1; 1; 1; 1; 1; 1; 1; 1; 1; 10; 11; 2;
2; 1; 1; 1; 1; 1; 1; 1; 1; 1; 1; 1; 1; 1; 1; 1; 1; 1; 1; 1; 1; 1; 1; 1; 1; 1; 1; 12; 13; 2;
2; 1; 1; 1; 1; 1; 1; 1; 1; 1; 1; 1; 1; 1; 1; 1; 1; 1; 1; 1; 1; 1; 1; 1; 1; 1; 1; 14; 15; 2;
2; 2; 2; 2; 2; 2; 2; 2; 2; 2; 2; 2; 2; 2; 2; 2; 2; 2; 2; 2; 2; 2; 2; 2; 2; 2; 2; 2; 2; 2;

2; 2; 2; 2; 2; 2; 2; 2; 2; 2; 2; 2; 2; 2; 2; 2; 2; 2; 2; 2; 2; 2; 2; 2; 2; 2; 2; 2; 2; 2;
2; 0; 0; 0; 0; 0; 0; 0; 0; 0; 0; 0; 0; 0; 0; 0; 0; 0; 0; 0; 0; 0; 0; 0; 0; 0; 0; 0; 0; 2;
2; 0; 0; 0; 20; 21; 0; 20; 21; 0; 20; 21; 0; 20; 21; 0; 20; 21; 0; 20; 21; 0; 20; 21; 0; 20; 21; 0; 0; 2;
2; 0; 0; 0; 7; 7; 0; 7; 7; 0; 7; 7; 0; 7; 7; 0; 7; 7; 0; 7; 7; 0; 7; 7; 0; 7; 7; 0; 0; 2;
2; 0; 0; 0; 0; 0; 0; 0; 0; 0; 0; 0; 0; 0; 0; 0; 0; 0; 0; 0; 0; 0; 0; 0; 0; 0; 0; 0; 0; 2;
2; 0; 0; 0; 0; 0; 0; 0; 0; 0; 0; 0; 0; 0; 0; 0; 0; 0; 0; 0; 0; 0; 0; 0; 0; 0; 0; 0; 0; 2;
2; 0; 0; 0; 0; 0; 0; 0; 0; 0; 0; 0; 0; 0; 0; 0; 0; 0; 0; 0; 0; 0; 0; 0; 0; 0; 0; 0; 0; 2;
2; 0; 0; 0; 19; 19; 19; 19; 19; 19; 19; 19; 19; 19; 19; 19; 19; 19; 19; 19; 19; 19; 19; 19; 19; 19; 0; 0; 0; 2;
2; 0; 0; 0; 19; 19; 19; 19; 19; 19; 19; 19; 19; 19; 19; 19; 19; 19; 19; 19; 19; 19; 19; 19; 19; 19; 0; 0; 0; 2;
2; 0; 0; 0; 0; 0; 0; 0; 0; 0; 0; 0; 0; 0; 0; 0; 0; 0; 0; 0; 0; 0; 0; 0; 0; 0; 0; 0; 0; 2;
2; 0; 0; 0; 0; 0; 0; 0; 0; 0; 0; 0; 0; 0; 0; 0; 0; 0; 0; 0; 0; 0; 0; 0; 0; 0; 0; 0; 0; 2;
2; 0; 0; 0; 19; 19; 19; 19; 19; 19; 19; 19; 19; 19; 19; 19; 19; 19; 19; 19; 19; 19; 19; 19; 19; 19; 0; 0; 0; 2;
2; 0; 0; 0; 19; 19; 19; 19; 19; 19; 19; 19; 19; 19; 19; 19; 19; 19; 19; 19; 19; 19; 19; 19; 19; 19; 0; 0; 0; 2;
2; 0; 0; 0; 0; 0; 0; 0; 0; 0; 0; 0; 0; 0; 0; 0; 0; 0; 0; 0; 0; 0; 0; 0; 0; 0; 0; 0; 0; 2;
2; 0; 0; 0; 0; 0; 0; 0; 0; 0; 0; 0; 0; 0; 0; 0; 0; 0; 0; 0; 0; 0; 0; 0; 0; 0; 0; 0; 0; 2;
2; 0; 0; 0; 19; 19; 19; 19; 19; 19; 19; 19; 19; 19; 19; 19; 19; 19; 19; 19; 19; 19; 19; 19; 19; 19; 0; 0; 0; 2;
2; 0; 0; 0; 19; 19; 19; 19; 19; 19; 19; 19; 19; 19; 19; 19; 19; 19; 19; 19; 19; 19; 19; 19; 19; 19; 0; 0; 0; 2;
2; 0; 0; 0; 0; 0; 0; 0; 0; 0; 0; 0; 0; 0; 0; 0; 0; 0; 0; 0; 0; 0; 0; 0; 0; 0; 0; 0; 0; 2;
2; 0; 0; 0; 0; 0; 0; 0; 0; 0; 0; 0; 0; 0; 0; 0; 0; 0; 0; 0; 0; 0; 0; 0; 0; 0; 0; 0; 0; 2;
2; 0; 0; 0; 0; 0; 0; 0; 0; 0; 0; 0; 0; 0; 0; 0; 0; 0; 0; 0; 0; 0; 0; 0; 0; 0; 0; 0; 0; 2;
2; 0; 0; 0; 3; 4; 5; 0; 3; 4; 5; 0; 3; 4; 5; 0; 22; 22; 22; 22; 0; 0; 0; 0; 0; 0; 0; 0; 0; 2;
2; 0; 0; 0; 0; 7; 0; 0; 0; 7; 0; 0; 0; 7; 0; 0; 7; 7; 7; 7; 0; 0; 0; 0; 0; 0; 0; 0; 0; 2;
2; 0; 0; 0; 0; 0; 0; 0; 0; 0; 0; 0; 0; 0; 0; 0; 0; 0; 0; 0; 0; 0; 0; 0; 0; 0; 0; 0; 0; 2;
2; 0; 0; 0; 0; 0; 0; 0; 0; 0; 0; 0; 0; 0; 0; 0; 0; 0; 0; 0; 0; 0; 0; 0; 0; 0; 0; 0; 0; 2;
2; 2; 2; 2; 2; 2; 2; 2; 2; 2; 2; 2; 2; 2; 2; 2; 2; 2; 2; 2; 2; 2; 2; 2; 2; 2; 2; 2; 2; 2;

2; 2; 2; 2; 2; 2; 2; 2; 2; 2; 2; 2; 2; 2; 2; 2; 2; 2; 2; 2; 2; 2; 2; 2; 2; 2; 2; 2; 2; 2;
2; 0; 0; 0; 0; 0; 0; 0; 0; 0; 0; 0; 0; 0; 0; 0; 0; 0; 0; 0; 0; 0; 0; 0; 0; 0; 0; 0; 0; 2;
2; 0; 0; 0; 0; 0; 0; 0; 0; 0; 0; 0; 0; 0; 0; 0; 0; 0; 0; 0; 0; 0; 0; 0; 0; 0; 0; 0; 0; 2;
2; 0; 0; 0; 0; 0; 0; 0; 0; 0; 0; 0; 0; 0; 0; 0; 0; 0; 0; 0; 0; 0; 0; 0; 0; 0; 0; 0; 0; 2;
2; 0; 0; 0; 0; 0; 0; 0; 0; 0; 0; 0; 0; 0; 0; 0; 0; 0; 0; 0; 0; 0; 0; 0; 0; 0; 0; 0; 0; 2;
2; 0; 0; 0; 0; 0; 0; 0; 0; 0; 0; 0; 0; 0; 0; 0; 0; 0; 0; 0; 0; 0; 0; 0; 0; 0; 0; 0; 0; 2;
2; 0; 0; 0; 0; 0; 0; 0; 0; 0; 0; 0; 0; 0; 0; 0; 0; 0; 0; 0; 0; 0; 0; 0; 0; 0; 0; 0; 0; 2;
2; 0; 0; 0; 0; 0; 0; 0; 0; 0; 0; 0; 0; 0; 0; 0; 0; 0; 0; 0; 0; 0; 0; 0; 0; 0; 0; 0; 0; 2;
2; 0; 0; 0; 0; 0; 0; 0; 0; 0; 0; 0; 0; 0; 0; 0; 0; 0; 0; 0; 0; 0; 0; 0; 0; 0; 0; 0; 0; 2;
2; 0; 0; 0; 0; 0; 0; 0; 0; 0; 0; 0; 0; 0; 0; 0; 0; 0; 0; 0; 0; 0; 0; 0; 0; 0; 0; 0; 0; 2;
2; 0; 0; 0; 0; 0; 0; 0; 0; 0; 0; 0; 0; 0; 0; 0; 0; 0; 0; 0; 0; 0; 0; 0; 0; 0; 0; 0; 0; 2;
2; 0; 0; 0; 0; 0; 0; 0; 0; 0; 0; 0; 0; 0; 0; 0; 0; 0; 0; 0; 0; 0; 0; 0; 0; 0; 0; 0; 0; 2;
2; 0; 0; 0; 0; 0; 0; 0; 0; 0; 0; 0; 0; 0; 0; 0; 0; 0; 0; 0; 0; 0; 0; 0; 0; 0; 0; 0; 0; 2;
2; 0; 0; 0; 0; 0; 0; 0; 0; 0; 0; 0; 0; 0; 0; 0; 0; 0; 0; 0; 0; 0; 0; 0; 0; 0; 0; 0; 0; 2;
2; 0; 0; 0; 0; 0; 0; 0; 0; 0; 0; 0; 0; 0; 0; 0; 0; 0; 0; 0; 0; 0; 0; 0; 0; 0; 0; 0; 0; 2;
2; 0; 0; 0; 0; 0; 0; 0; 0; 0; 0; 0; 0; 0; 0; 0; 0; 0; 0; 0; 0; 0; 0; 0; 0; 0; 0; 0; 0; 2;
2; 0; 0; 0; 0; 0; 0; 0; 0; 0; 0; 0; 0; 0; 0; 0; 0; 0; 0; 0; 0; 0; 0; 0; 0; 0; 0; 0; 0; 2;
2; 0; 0; 0; 0; 0; 0; 0; 0; 0; 0; 0; 0; 0; 0; 0; 0; 0; 0; 0; 0; 0; 0; 0; 0; 0; 0; 0; 0; 2;
2; 0; 0; 0; 0; 0; 0; 0; 0; 0; 0; 0; 0; 0; 0; 0; 0; 0; 0; 0; 0; 0; 0; 0; 0; 0; 0; 0; 0; 2;
2; 0; 0; 0; 0; 8; 0; 0; 0; 8; 0; 0; 0; 8; 0; 0; 0; 0; 0; 0; 0; 0; 0; 0; 0; 0; 0; 0; 0; 2;
2; 0; 0; 0; 0; 9; 0; 0; 0; 9; 0; 0; 0; 9; 0; 0; 0; 0; 0; 0; 0; 0; 0; 0; 0; 0; 0; 0; 0; 2;
2; 0; 0; 0; 0; 0; 0; 0; 0; 0; 0; 0; 0; 0; 0; 0; 0; 0; 0; 0; 0; 0; 0; 0; 0; 0; 0; 0; 0; 2;
2; 0; 0; 0; 0; 0; 0; 0; 0; 0; 0; 0; 0; 0; 0; 0; 0; 0; 0; 0; 0; 0; 0; 0; 0; 0; 0; 0; 0; 2;
2; 0; 0; 0; 0; 0; 0; 0; 0; 0; 0; 0; 0; 0; 0; 0; 0; 0; 0; 0; 0; 0; 0; 0; 0; 0; 0; 0; 0; 2;
2; 2; 2; 2; 2; 2; 2; 2; 2; 2; 2; 2; 2; 2; 2; 2; 2; 2; 2; 2; 2; 2; 2; 2; 2; 2; 2; 2; 2; 2;

B Rect=(0,-1,60,1600) #BLOCK MUR GAUCHE
B Rect=(0,1856,60,1600) #BLOCK MUR DROIT
B Rect=(0,-1,1900,60) #LINE TOP
B Rect=(1540,-1,1900,60) #LINE BOTTOM
B Rect=(450,265,1385,128) #SERVEUR LINE 1
B Rect=(703,265,1385,128) #SERVEUR LINE 2
B Rect=(963,265,1385,128) #SERVEUR LINE 3
B Rect=(1280,253,200,100) #COMPUTER 1
B Rect=(1280,507,200,100) #COMPUTER 2
B Rect=(1280,763,200,100) #COMPUTER 3
B Rect=(1280,1030,240,100) #LITTLE PC 1
B Rect=(130,255,130,100) #CONSOLE TOP 1
B Rect=(130,447,130,100) #CONSOLE TOP 2
B Rect=(130,640,130,100) #CONSOLE TOP 3
B Rect=(130,832,130,100) #CONSOLE TOP 4
B Rect=(130,1022,130,100) #CONSOLE TOP 5
B Rect=(130,1215,130,100) #CONSOLE TOP 6
B Rect=(130,1407,130,100) #CONSOLE TOP 7
B Rect=(130,1600,130,100) #CONSOLE TOP 8

E Pos_rect=(80,80) Size_rect=(100,180) Active=1 ID=10 Contact=change_map Effect="Path='assets/map/openspace' Pos=(1700,1300) "
E Pos_rect=(1740,1350) Size_rect=(100,180) Active=1 ID=10 Contact=change_map Path="tests/arbre.png" Effect="Path='assets/map/biodome' Pos=(200,200) "
# ROBOT GRIS
E Pos_obj=(870,300) Rect=(0,370,100,100) Pos_rect=(1030,270) Active=1 Size_rect=(70,70) Path_obj="assets/images/enemies.png" ID=3 Contact=duel Effect="ID=10 Lvl=2 Reward=(XP=20 Item={Name='Life Magnifier' Type='Usage' Nbr=10 ID=10 HP_max=20}) "
E Pos_obj=(1000,300) Rect=(0,370,100,100) Pos_rect=(1160,270) Active=1 Size_rect=(70,70) Path_obj="assets/images/enemies.png" ID=3 Contact=duel Effect="ID=10 Lvl=2 Reward=(XP=20 Item={Name='Mag-Gun MK-II' Type='Weapon' Nbr=1 ID=1 AD=14 AP=10}) "
# ROBOT BLEU
E Pos_obj=(70,600) Rect=(0,300,50,100) Pos_rect=(210,570) Active=1 Size_rect=(50,70) Path_obj="assets/images/enemies.png" ID=4 Contact=duel Effect="ID=10 Lvl=2 Reward=(XP=20 Item={Name='H-Pod 1.1' Type='Weapon' Nbr=1 ID=2 Mana_max=20 AD=8 AP=20}) "
E Pos_obj=(1570,600) Rect=(0,300,50,100) Pos_rect=(1710,570) Active=1 Size_rect=(50,70) Path_obj="assets/images/enemies.png" ID=4 Contact=duel Effect="ID=10 Lvl=2 Reward=(XP=20 Item={Name='Cyberjoint Epsilon' Type='Weapon' Nbr=1 ID=3 AD=18 AP=9}) "
# BOSS
E Pos_obj=(900,1100) Rect=(0,250,50,100) Pos_rect=(990,1090) Active=1 Size_rect=(50,70) Path_obj="assets/images/enemies.png" ID=7 Contact=duel Effect="ID=10 Lvl=2 Reward=(XP=20 Item={Name='Knowledge Mask' Type='Head' Nbr=1 ID=7 Armor=20 Magic_Resi=20 HP_max=20 AP=20 AD=20 Speed=-9}) "
